11111111111
10EPC000001
100E000E001
11111111111
